1111111111111111111111111111111111111111
1                                      1
1                                      1
1          111             111         1
1    111  11111           11111  111   1
1    111  11111     2     11111  111   1
1    111  11111           11111  111   1
1          111             111         1
1                                      1
1                  111                 1
1    2             1C1             2   1
1                  1 1                 1
1                                      1
1          111             111         1
1    111  11111           11111  111   1
1    111  11111           11111  111   1
1    111  11111           11111  111   1
1          111             111         1
1                                      1
1          00               00         1
1          00               00         1
1                                      1
1          111             111         1
1    111  11111           11111  111   1
1    111  11111           11111  111   1
1    111  11111           11111  111   1
1          111             111         1
1                                      1
1          00               00         1
1          00               00         1
1                                      1
1          111             111         1
1    111  11111           11111  111   1
1    111  11111           11111  111   1
1    111  11111           11111  111   1
1          111             111         1
1                                      1
1                                      1
1                                      1
1111111111111111111111111111111111111111
