0000000000000000000000000000000000000000
0          1            1              0
0   2  2   1            1              0
0          1            1     2  2     0
0          1            1              0
0          1            1              0
0          111111111    111111111111 1 0
0          1            1              0
0          1            1      2       0
0          1            1              0
0                       1              0
0                       11111111 1 11110
0111111111111111        1              0
0                       1              0
0   2                   1       2      0
0                       1              0
0                       1              0
01111111111111111       1111111111111  0
0               1                      0
0               1                      0
0      2                               0
0               1                      0
0               1                      0
0        11111111        111111111111110
0        1      1                      0
0111111111   2  1                      0
0        1      1                  2   0
0    2   1                             0
0        1      1                      0
0        1      1                      0
0        11111111111111   11111111111110
0        1                    1        0
0        1                    1    2   0
0        1                    1        0
0                             1        0
0        1111111111111        1        0
0        1         1D1        1        0
0        1   2     1 1                 0
0        1                             0
0000000000000000000000000000000000000000
