0000000000000000000000000000000000000000
0                         1           10
0  1       1          1           11  10
0    1  1                         11AA10
0    1             1 1            111110
0    1   1   1       1                 0
0       1    1            1            0
0  1 1            1    1       1       0
0      1    1 1                  1     0
0               1       1  1       1   0
0          1 1  1    1        1  1     0
0     1             1  1    1          0
0 1        1    1   1      1    1      0
0                         1            0
0       2                          2   0
0    1      1        1       2  1      0
0                   2    1             0
0           1        1 2               0
0     1             2         1        0
0                  1                   0
0        1  1         1    2           0
0          11          2   1           0
0             2     1             1    0
0       2             1 1       2      0
0                   2    1             0
0  1       1                 1         0
0       2   1     1                    0
0             2  1                     0
0     1       2  1                     0
0     11   1 2       1             2   0
0                2   1       1       2 0
0             2                 2      0
0              1 2              2  1   0
0       1    2       1       2         0
0      1   1    1                      0
0          2                  1        0
0       2                          2   0
0       1         1       1            0
0                    1          1      0
0000000000000000000000000000000000000000
